-1,-1,-1,-1,-1,1,1,1,1,1,1,1,1,1,1
-1,-1,-1,-1,-1,1,1,1,1,1,1,3,4,5,1
-1,-1,-1,2,2,1,0,1,1,1,1,6,7,8,1
1,1,1,1,1,1,1,1,1,1,1,9,10,11,1
1,1,1,1,1,1,0,1,1,1,1,-1,-1,-1,1
1,3,4,5,1,1,1,1,1,1,1,-1,-1,-1,1
1,6,7,8,1,1,1,1,1,1,1,-1,-1,-1,1
1,9,10,11,1,1,1,1,1,1,1,-1,-1,-1,1
1,1,1,1,1,1,1,1,1,1,1,-1,-1,-1,1
1,1,1,1,1,1,1,1,1,1,1,1,1,1,1
1,1,1,1,1,1,1,1,1,1,1,1,1,1,1
1,1,1,1,1,1,1,1,1,1,1,1,1,1,1
1,1,1,1,1,1,1,1,1,1,1,1,1,1,1
1,1,1,1,1,1,1,1,1,1,1,1,1,1,1
1,1,1,1,1,1,1,1,1,1,1,1,1,1,1
